2 2 2 2 2 2 2 2 2 2 2 2 2 2 2 2 2 2 0 2 2 2 2 2 2 2 2
2 2 2 2 2 2 2 0 0 0 0 0 0 0 0 0 2 2 0 2 0 0 0 2 2 2 2
2 2 2 0 0 0 2 0 6 0 6 0 0 0 0 0 0 2 2 0 6 0 0 0 0 2 2
2 0 0 0 0 6 0 0 4 0 4 0 0 6 0 0 0 2 0 0 6 0 0 0 0 0 2
2 0 0 6 0 3 2 2 3 3 3 3 2 2 0 0 0 0 0 0 0 0 0 6 6 0 2
2 6 0 3 0 0 0 0 0 0 0 0 2 0 0 0 6 0 0 0 0 4 2 3 3 2 2
2 3 0 0 0 0 0 0 0 0 0 0 0 0 0 4 2 2 0 0 2 2 2 0 0 2 2
2 0 6 2 0 0 4 0 0 0 0 0 0 6 2 2 2 2 0 0 2 2 2 0 0 2 2
2 0 3 2 2 2 2 2 4 0 0 0 0 2 2 2 2 2 4 0 0 2 2 0 0 0 2
2 0 0 0 0 2 2 2 2 2 6 0 0 0 0 2 2 2 2 0 0 0 0 0 0 0 2
2 2 0 0 0 0 0 0 0 0 3 0 6 0 0 0 0 2 0 0 0 0 0 0 0 6 2
2 2 0 0 0 6 0 0 0 0 0 0 2 0 0 0 0 0 0 0 6 0 0 0 6 2 2
2 2 0 0 0 2 0 0 4 0 0 2 2 2 0 6 4 6 0 2 2 0 0 4 2 2 2
2 2 2 2 0 0 0 2 2 2 0 0 0 0 0 2 2 2 0 0 0 0 2 2 2 2 2
2 2 2 2 5 5 5 2 2 2 5 5 5 5 5 2 2 2 5 5 5 5 2 2 2 2 2 
